{
    "floors": [
        {
            "theme": "Molecule Man",
            "map": [
                [7, 8, 8, 8, 8, 8, 8, 8, 8, 8, 8, 8, 8, 8, 8, 8, 8, 8, 8, 9],
                [11, 3, 3, 3, 3, 3, 0, 3, 5, 3, 3, 3, 3, 3, 3, 3, 3, 3, 3, 13],
                [11, 3, 1, 3, 3, 3, 0, 3, 5, 3, 3, 3, 3, 3, 3, 3, 3, 3, 3, 13],
                [11, 3, 1, 1, 4, 4, 0, 4, 5, 0, 3, 5, 3, 3, 3, 3, 3, 3, 3, 13],
                [11, 3, 1, 1, 3, 1, 3, 3, 3, 5, 5, 5, 5, 3, 1, 1, 3, 3, 3, 13],
                [11, 3, 3, 2, 3, 1, 1, 3, 0, 5, 5, 5, 5, 3, 1, 1, 3, 3, 3, 13],
                [11, 3, 3, 2, 1, 1, 1, 3, 3, 5, 5, 3, 5, 5, 1, 5, 2, 2, 3, 13],
                [11, 3, 2, 2, 3, 1, 2, 3, 3, 3, 3, 3, 5, 5, 3, 5, 2, 2, 3, 13],
                [11, 3, 2, 3, 3, 2, 2, 2, 2, 3, 3, 5, 5, 5, 5, 5, 2, 4, 3, 13],
                [11, 3, 2, 3, 3, 2, 2, 2, 2, 3, 3, 3, 3, 3, 3, 3, 4, 4, 3, 13],
                [11, 3, 3, 3, 3, 2, 2, 2, 2, 3, 3, 3, 3, 3, 3, 3, 4, 4, 3, 13],
                [11, 3, 3, 3, 2, 2, 3, 3, 3, 3, 3, 3, 3, 3, 3, 3, 4, 3, 3, 13],
                [11, 3, 3, 0, 0, 0, 0, 0, 0, 0, 0, 0, 0, 0, 0, 0, 3, 6, 3, 13],
                [12, 8, 8, 8, 8, 8, 8, 8, 8, 8, 8, 8, 8, 8, 8, 8, 8, 8, 8, 10]
            ]
        }
    ]
}
