{
    "floors": [
        {
            "theme": "./assets/img/map/AssetsDG.png",
            "map": [
                [7, 8, 8, 8, 8, 8, 8, 8, 8, 8, 8, 8, 8, 8, 8, 8, 8, 8, 8, 9],
                [11, 3, 3, 3, 3, 3, 0, 3, 5, 3, 3, 3, 3, 3, 3, 3, 3, 3, 3, 13],
                [11, 3, 1, 3, 3, 3, 0, 3, 5, 3, 3, 3, 3, 3, 3, 3, 3, 3, 3, 13],
                [11, 3, 1, 1, 4, 4, 0, 4, 5, 0, 3, 5, 3, 3, 3, 3, 3, 3, 3, 13],
                [11, 3, 1, 1, 3, 1, 3, 3, 3, 5, 5, 5, 5, 3, 1, 1, 3, 3, 3, 13],
                [11, 3, 3, 2, 3, 1, 1, 3, 0, 5, 5, 5, 5, 3, 1, 1, 3, 3, 3, 13],
                [11, 3, 3, 2, 1, 1, 1, 3, 3, 5, 5, 3, 5, 5, 1, 5, 2, 2, 3, 13],
                [11, 3, 2, 2, 3, 1, 2, 3, 3, 3, 3, 3, 5, 5, 3, 5, 2, 2, 3, 13],
                [11, 3, 2, 3, 3, 2, 2, 2, 2, 3, 3, 5, 5, 5, 5, 5, 2, 4, 3, 13],
                [11, 3, 2, 3, 3, 2, 2, 2, 2, 3, 3, 3, 3, 3, 3, 3, 4, 4, 3, 13],
                [11, 3, 3, 3, 3, 2, 2, 2, 2, 15, 3, 3, 3, 3, 3, 3, 4, 4, 3, 13],
                [11, 3, 3, 3, 2, 2, 3, 3, 3, 3, 3, 3, 3, 3, 3, 3, 4, 15, 3, 13],
                [11, 0, 15, 1, 6, 0, 0, 0, 0, 0, 0, 0, 0, 0, 0, 0, 0, 1, 0, 13],
                [12, 14, 14, 14, 14, 14, 14, 14, 14, 14, 14, 14, 14, 14, 14, 14, 14, 14, 14, 10]
            ]
        },
        {
            "theme": "./assets/img/map/AssetsDG2.png",
            "map": [
                [7, 8, 8, 8, 8, 8, 8, 8, 8, 8, 8, 8, 8, 8, 8, 8, 8, 8, 8, 9],
                [11, 3, 1, 1, 1, 1, 0, 1, 5, 1, 1, 1, 3, 3, 3, 3, 3, 3, 3, 13],
                [11, 3, 1, 3, 3, 3, 0, 3, 5, 3, 3, 3, 3, 3, 3, 3, 3, 3, 3, 13],
                [11, 3, 1, 1, 4, 4, 0, 4, 5, 0, 3, 5, 3, 3, 3, 3, 3, 3, 3, 13],
                [11, 3, 1, 1, 15, 1, 3, 3, 3, 5, 5, 5, 5, 3, 1, 1, 3, 3, 3, 13],
                [11, 3, 3, 2, 3, 1, 1, 3, 0, 5, 5, 5, 5, 3, 1, 1, 3, 3, 3, 13],
                [11, 3, 3, 2, 1, 1, 1, 3, 3, 5, 5, 3, 5, 5, 1, 5, 2, 2, 6, 13],
                [11, 3, 2, 2, 3, 1, 2, 3, 3, 3, 3, 3, 5, 5, 3, 5, 2, 2, 3, 13],
                [11, 3, 2, 3, 3, 4, 4, 4, 2, 3, 3, 5, 5, 5, 5, 5, 2, 4, 3, 13],
                [11, 3, 2, 3, 3, 2, 2, 2, 2, 3, 3, 3, 3, 3, 3, 3, 4, 15, 3, 13],
                [11, 3, 3, 3, 3, 2, 2, 2, 2, 1, 3, 3, 15, 3, 3, 3, 4, 4, 3, 13],
                [11, 3, 3, 3, 2, 2, 3, 3, 3, 3, 3, 3, 3, 3, 3, 3, 4, 1, 3, 13],
                [11, 0, 2, 1, 1, 0, 0, 0, 0, 0, 0, 0, 0, 0, 0, 0, 0, 1, 0, 13],
                [12, 14, 14, 14, 14, 14, 14, 14, 14, 14, 14, 14, 14, 14, 14, 14, 14, 14, 14, 10]
            ]
        },
        {
            "theme": "./assets/img/map/AssetsDG3.png",
            "map": [
                [7, 8, 8, 8, 8, 8, 8, 8, 8, 8, 8, 8, 8, 8, 8, 8, 8, 8, 8, 9],
                [11, 3, 1, 2, 2, 2, 0, 2, 5, 2, 2, 2, 3, 3, 3, 3, 3, 3, 3, 13],
                [11, 3, 1, 2, 2, 2, 0, 2, 5, 2, 2, 2, 3, 3, 3, 3, 3, 3, 3, 13],
                [11, 3, 1, 1, 4, 4, 0, 4, 5, 0, 3, 5, 3, 3, 3, 3, 15, 3, 3, 13],
                [11, 3, 1, 1, 4, 1, 3, 3, 3, 5, 5, 5, 2, 3, 1, 1, 3, 3, 3, 13],
                [11, 3, 3, 2, 3, 1, 1, 3, 0, 5, 5, 2, 5, 1, 1, 1, 3, 3, 3, 13],
                [11, 3, 3, 2, 1, 1, 1, 3, 3, 5, 2, 13, 1, 5, 1, 5, 2, 2, 6, 13],
                [11, 3, 2, 2, 3, 1, 2, 15, 3, 3, 3, 13, 5, 5, 3, 5, 2, 2, 3, 13],
                [11, 3, 2, 3, 2, 4, 4, 4, 2, 3, 3, 13, 5, 5, 5, 5, 2, 4, 3, 13],
                [11, 3, 6, 3, 3, 1, 2, 2, 2, 3, 3, 3, 3, 3, 3, 3, 4, 2, 3, 13],
                [11, 3, 3, 3, 3, 2, 2, 2, 2, 15, 3, 3, 2, 3, 3, 3, 4, 4, 3, 13],
                [11, 3, 3, 3, 2, 2, 3, 3, 3, 3, 3, 3, 3, 3, 3, 3, 4, 1, 3, 13],
                [11, 0, 2, 1, 1, 0, 0, 0, 0, 0, 0, 0, 0, 0, 0, 0, 0, 1, 0, 13],
                [12, 14, 14, 14, 14, 14, 14, 14, 14, 14, 14, 14, 14, 14, 14, 14, 14, 14, 14, 10]
            ]
        }
    ]
}
